000000002000000000000000000000000000000000000000000000000000000000000000000000000000000000000000000000000000000000000000000000000000000000000000000000000000200000000
000000002000000000000000000000000000000000000000000000000000000000000000000000000000000000000000000000000000000000000000000000000000000000000000000000000000200000000
000000002000000000000000000000000000000000000000000000000000000000000000000000000000000000000000000000000009000000000000000000000000000000000000000000000000200000000
000000002000000000000000000000000000000000000000000000000000000009000000000000000000000000000000000000033333330000000000000000000000000000000000000000000000200000000
000000002000000000000000000000000000000000090000000000000900033333300000009000000000000000500003000330000000000000000000000000000000000000000000000000000000200000000
000000002000000000000000000000000000000000333330000000033300000000000000033300000000000033333000000000000000000000000000000000000000000000059000000000000000200000000
000000002000000000033300000000090000003300000000003330000000000005000330000000000000330000111000000000000000000010000010000000000000000300333330001000000000200000000
000000002000003330000000000003333333000000000000001110000000000003300000000000333300000000444100000000000000000041000040000000000333300000000000004000000000200000000
000000002050900000090000011000000000000000000000004441000000900000000009000000111100009000444410000000000000000044100040000000000090000000000000004000000060200000000
111111111111111111111111144111111111111111111100114444110011111111111111110000444411111111444441111111111111111144400041110000111111111111111111114111111111111111111
444444444444444444444444444444444444444444444410000000000144444444444444441111444444444444444444444444444444444444400000000011444444444444444444444444444444444444444
444444444444444444444444444444444444444444444441000090001444444444444444444444444444444444444444444444444444444444400009001144444444444444444444444444444444444444444
444444444444444444444444444444444444444444444444444444444444444444444444444444444444444444444444444444444444444444444444444444444444444444444444444444444444444444444
444444444444444444444444444444444444444444444444444444444444444444444444444444444444444444444444444444444444444444444444444444444444444444444444444444444444444444444
000000000000000000000000000000000000000444444444444444444444444444444444444444444444444444444444444444444444444444444444444444444444444444444444444444444444444444444
000000000000000000000000000000000000000444444444444444444444444444444444444444444444444444444444444444444444444444444444444444444444444444444444444444444444444444444
