00000000000000000000
00000000000000000000
00000000000000000000
00000000000000000000
00000000000000000000
00000000000000000000
00111111110000000000
00000000001111000000
00011000000000000000
00002000000000000111
11111111111111111111